78
15
0 0 0 0 0 0 0 0 0 0 0 0 0 0 0 0 0 0 0 0 0 0 0 0 0 0 0 0 0 0 0 0 0 0 0 0 0 0 0 0 0 0 0 0 0 0 0 0 0 0 0 0 0 0 0 0 0 0 0 0 0 0 0 0 0 0 0 0 0 0 0 0 0 0 0 0 0 0 
0 0 0 0 0 0 0 0 0 0 0 0 0 0 0 0 0 0 0 0 0 0 0 0 0 0 0 0 0 0 0 0 0 0 0 0 0 0 0 0 0 0 0 0 0 0 0 0 0 0 0 0 0 0 0 0 0 0 0 0 0 0 0 0 0 0 0 0 0 0 0 0 0 0 0 0 0 0 
0 0 0 0 0 0 0 0 0 0 0 0 0 0 0 0 0 0 0 0 0 0 0 0 0 0 0 0 0 0 0 0 0 0 0 0 0 0 0 0 0 0 0 0 0 0 0 0 0 0 0 0 0 15 16 0 0 0 0 0 0 0 0 0 0 0 0 0 0 0 0 0 0 0 0 0 0 0 
0 0 0 0 0 0 0 0 0 0 0 0 0 0 0 0 0 0 0 0 0 0 0 0 0 0 0 0 0 0 0 0 0 0 0 0 0 0 0 0 0 0 0 0 0 0 0 0 0 0 0 0 0 15 16 0 0 0 0 0 0 0 0 0 0 0 0 0 0 0 0 0 0 0 0 0 0 0 
0 0 0 0 0 0 0 0 0 0 0 0 0 0 0 0 0 0 0 0 0 0 0 0 0 0 0 0 0 0 0 0 0 0 0 0 0 0 0 0 0 0 0 0 0 0 0 0 0 0 0 0 0 15 16 0 0 0 0 0 0 0 0 0 0 0 0 0 0 0 0 0 0 0 0 0 0 0 
0 0 0 0 0 0 0 0 0 0 0 0 0 15 16 0 0 0 0 0 0 0 0 0 0 0 0 0 0 15 16 0 15 16 0 15 16 0 0 0 0 0 0 0 0 0 0 0 0 0 0 0 0 15 16 0 0 0 0 0 0 0 0 0 0 0 0 0 0 0 0 0 0 0 0 0 0 0 
0 0 0 0 0 0 0 0 0 0 0 0 0 15 16 0 0 0 0 0 0 0 0 0 0 0 0 0 0 15 16 0 15 16 0 15 16 0 0 0 0 0 0 0 0 0 0 0 0 0 0 0 0 15 16 0 0 0 0 0 0 0 0 0 0 0 0 0 0 0 0 0 0 0 0 0 0 0 
0 0 0 0 0 0 0 0 0 0 0 0 0 15 16 0 0 0 0 0 0 0 0 0 0 0 0 0 0 15 16 0 15 16 0 15 16 0 0 0 0 0 0 0 0 0 0 0 0 0 0 0 0 15 16 0 0 0 0 0 0 0 0 0 0 0 0 0 0 0 0 0 0 0 0 0 0 0 
0 0 0 0 0 0 0 0 0 0 0 0 0 15 16 0 18 14 18 0 0 0 0 0 0 0 0 0 0 15 16 0 15 16 0 15 16 0 0 1 5 2 3 0 0 0 0 0 0 0 0 0 0 15 16 0 0 0 9 11 12 13 10 0 14 0 0 0 0 0 0 0 0 0 0 0 0 0 
3 0 0 0 0 0 0 0 0 0 0 0 32 15 16 0 55 53 54 7 0 0 0 0 0 0 0 0 0 15 16 0 15 16 0 30 31 0 0 40 41 41 45 7 0 0 11 12 12 13 0 0 0 30 31 0 0 52 56 53 53 53 53 53 60 7 0 0 0 0 0 0 0 0 0 0 0 0 
42 0 0 0 0 0 0 0 0 0 0 0 32 30 31 0 64 65 66 8 0 0 0 0 0 0 0 0 0 15 16 0 30 31 0 70 71 0 0 46 47 50 51 8 0 0 52 53 56 54 0 0 23 70 71 0 0 64 65 65 68 65 65 65 66 8 0 0 0 4 2 2 5 2 6 0 0 0 
48 0 0 0 0 0 0 0 4 2 2 6 0 70 71 0 64 65 66 8 0 0 0 0 0 0 0 0 0 30 31 0 70 71 0 0 0 0 0 49 50 50 51 8 0 0 64 65 65 63 0 0 0 0 0 0 0 64 65 65 65 65 65 65 66 8 0 0 0 43 41 41 41 44 42 0 0 0 
51 11 12 12 13 0 14 0 40 44 41 45 0 0 0 0 64 62 66 8 0 0 0 0 10 0 9 0 22 70 71 0 0 0 0 0 0 0 0 49 50 50 48 8 0 0 67 65 65 66 0 0 0 0 0 0 0 67 65 65 65 62 65 65 66 8 0 0 0 49 50 50 47 50 51 0 0 0 
51 52 56 53 53 53 57 7 46 50 50 51 0 0 0 0 67 65 66 8 0 0 17 52 56 53 60 0 0 0 0 0 0 0 0 0 0 0 0 49 47 50 51 8 0 0 64 65 65 69 0 0 0 0 0 0 0 64 65 62 65 65 65 65 69 8 0 0 0 49 47 50 50 50 51 0 0 0 
48 64 65 65 65 68 66 8 49 50 47 51 0 0 0 0 64 65 66 8 0 0 0 64 65 65 66 0 0 0 0 0 0 0 0 0 0 0 0 49 50 50 51 8 0 0 64 65 65 66 0 0 0 0 0 0 0 64 65 65 65 65 65 65 66 8 0 0 0 49 50 50 50 50 51 0 0 0 
